=== 1. PALABRAS ESENCIALES (pronombres, artículos, preposiciones, verbos básicos) ===
I = yo
you = tú / usted / ustedes
he = él
she = ella
it = eso
we = nosotros
they = ellos / ellas
me = mí
him = él (objeto)
her = ella (objeto)
us = nosotros (objeto)
them = ellos / ellas (objeto)
my = mi
your = tu / su
his = su (de él)
her = su (de ella)
its = su (de ello)
our = nuestro
their = su (de ellos)
this = esto / esta
that = eso / esa
these = estos / estas
those = esos / esas
the = el / la / los / las
a = un / una
an = un / una (antes de vocal)
and = y
or = o
but = pero
not = no
to = a / para
of = de
in = en / dentro de
on = en / sobre
at = en (lugares específicos)
for = para / por
with = con
by = por / mediante
from = de / desde
as = como / mientras
into = dentro de
through = a través de
about = sobre / acerca de
after = después
before = antes
between = entre
among = entre (más de dos)
during = durante
since = desde / ya que
until = hasta
while = mientras
all = todo
each = cada
every = cada (sin excepción)
some = algunos / algo
any = algún / ninguno
no = no
much = mucho (incontable)
many = muchos (contable)
more = más
most = mayoría / más
few = pocos
little = poco (incontable)
less = menos (incontable)
fewer = menos (contable)
very = muy
too = también / demasiado
so = tan / así que
just = justo / recién / solo
only = solo / solamente
also = también
well = bien
there = ahí / allí
here = aquí
now = ahora
then = entonces
today = hoy
tomorrow = mañana
yesterday = ayer
always = siempre
never = nunca
sometimes = a veces
usually = usualmente
often = a menudo
already = ya
yet = todavía (en negativas/preguntas)
ever = alguna vez
still = todavía

=== 2. VERBOS ULTRACOMUNES ===
be = ser / estar
have = tener / haber
do = hacer
go = ir
say = decir
get = obtener / conseguir / volverse
make = hacer / fabricar
know = saber / conocer
think = pensar / creer
see = ver
come = venir
take = tomar / llevar
want = querer
give = dar
use = usar
find = encontrar
tell = contar / decir
ask = preguntar
work = trabajar
call = llamar
try = intentar
look = mirar
need = necesitar
feel = sentir
become = convertirse en
leave = salir / dejar
put = poner
mean = significar
keep = mantener / guardar
let = dejar / permitir
begin = comenzar
seem = parecer
help = ayudar
show = mostrar
hear = oír
play = jugar / tocar (instrumento)
run = correr
move = mover
live = vivir
believe = creer
bring = traer
happen = suceder
write = escribir
provide = proporcionar
sit = sentarse
stand = estar de pie
lose = perder
pay = pagar
meet = conocer / reunirse
include = incluir
continue = continuar
set = establecer
learn = aprender
change = cambiar
lead = liderar
understand = entender
watch = mirar (TV, eventos)
follow = seguir
stop = parar
create = crear
speak = hablar
read = leer
allow = permitir
add = añadir
spend = gastar (tiempo/dinero)
grow = crecer
open = abrir
walk = caminar
win = ganar
offer = ofrecer
remember = recordar
consider = considerar
appear = aparecer
buy = comprar
wait = esperar
serve = servir
die = morir
send = enviar
build = construir
stay = quedarse
fall = caer
cut = cortar
reach = alcanzar
kill = matar
remain = permanecer
suggest = sugerir
raise = levantar / criar
pass = pasar
sell = vender
require = requerir
report = reportar
decide = decidir
pull = tirar
return = devolver / regresar
explain = explicar
develop = desarrollar
carry = llevar
break = romper
receive = recibir
accept = aceptar
catch = atrapar
save = salvar / ahorrar
lift = levantar
throw = lanzar
teach = enseñar
visit = visitar
contain = contener
improve = mejorar
achieve = lograr
avoid = evitar
enjoy = disfrutar
mind = importar (en preguntas)
prefer = preferir
realize = darse cuenta
suppose = suponer
wonder = preguntarse
promise = prometer
apologize = disculparse
complain = quejarse
agree = estar de acuerdo
disagree = estar en desacuerdo
hate = odiar
love = amar
like = gustar
hope = esperar
expect = esperar
wish = desear

=== 3. SUSTANTIVOS COTIDIANOS ===
time = tiempo
day = día
year = año
week = semana
hour = hora
minute = minuto
second = segundo
life = vida
world = mundo
work = trabajo
job = empleo
home = hogar
house = casa
family = familia
friend = amigo
person = persona
man = hombre
woman = mujer
child = niño
kid = niño (coloquial)
son = hijo
daughter = hija
father = padre
dad = papá (coloquial)
mother = madre
mom = mamá (coloquial)
wife = esposa
husband = esposo
people = gente
name = nombre
place = lugar
thing = cosa
way = manera / camino
part = parte
side = lado
end = fin
point = punto
fact = hecho
problem = problema
question = pregunta
answer = respuesta
reason = razón
story = historia
news = noticias
information = información
idea = idea
mind = mente
heart = corazón
body = cuerpo
hand = mano
eye = ojo
ear = oreja
mouth = boca
hair = pelo
face = cara
head = cabeza
leg = pierna
foot = pie
water = agua
food = comida
meal = comida (completa)
breakfast = desayuno
lunch = almuerzo
dinner = cena
money = dinero
price = precio
number = número
word = palabra
language = idioma
English = inglés
school = escuela
university = universidad
teacher = profesor
student = estudiante
book = libro
paper = papel
pen = bolígrafo
phone = teléfono
computer = ordenador
car = coche
bus = autobús
train = tren
plane = avión
road = carretera
street = calle
city = ciudad
town = pueblo / ciudad pequeña
country = país
room = habitación
bed = cama
table = mesa
chair = silla
door = puerta
window = ventana
light = luz
wall = pared
floor = suelo
garden = jardín
kitchen = cocina
bathroom = baño
toilet = inodoro
shower = ducha
clothes = ropa
shirt = camisa
T-shirt = camiseta
pants = pantalones
dress = vestido
shoes = zapatos
bag = bolsa
wallet = cartera

=== 4. ADJETIVOS COMUNES ===
good = bueno
bad = malo
great = genial
nice = bonito / agradable
fine = bien / fino
well = bien (estado)
new = nuevo
old = viejo
young = joven
big = grande
large = grande (formal)
huge = enorme
small = pequeño
little = pequeño (afectivo)
tiny = diminuto
long = largo
short = corto
high = alto
low = bajo
tall = alto (personas)
fast = rápido
quick = rápido (acción)
slow = lento
easy = fácil
difficult = difícil
hard = difícil / duro
simple = simple
complex = complejo
clear = claro
clean = limpio
dirty = sucio
full = lleno
empty = vacío
open = abierto
closed = cerrado
free = libre / gratis
busy = ocupado
available = disponible
right = correcto / derecho
wrong = equivocado
true = verdadero
false = falso
real = real
fake = falso
same = mismo
different = diferente
similar = similar
special = especial
important = importante
necessary = necesario
possible = posible
impossible = imposible
sure = seguro
certain = seguro
ready = listo
prepared = preparado
safe = seguro
dangerous = peligroso
hot = caliente
cold = frío
warm = cálido
cool = fresco / genial
wet = mojado
dry = seco
loud = fuerte (sonido)
quiet = callado
noisy = ruidoso
beautiful = hermoso
ugly = feo
happy = feliz
sad = triste
angry = enfadado
excited = emocionado
nervous = nervioso
calm = tranquilo
tired = cansado
awake = despierto
asleep = dormido
sick = enfermo
healthy = sano
strong = fuerte
weak = débil
smart = inteligente
stupid = tonto
kind = amable
rude = grosero
polite = educado
friendly = amigable
shy = tímido
brave = valiente
afraid = asustado
scared = asustado
proud = orgulloso
ashamed = avergonzado
guilty = culpable
sure = seguro
unsure = inseguro
confident = seguro de sí mismo
overwhelmed = abrumado
bored = aburrido
interested = interesado
amazing = asombroso
awesome = increíble
wonderful = maravilloso
terrible = terrible
awful = horrible
funny = divertido
serious = serio
lazy = perezoso
hardworking = trabajador
resilient = resiliente
thorough = minucioso

=== 5. EXPRESIONES COLLOQUIALES Y CONTRACCIONES ===
I'm = I am = soy / estoy
you're = you are = eres / estás
he's = he is = es / está
she's = she is = es / está
it's = it is = es / está
we're = we are = somos / estamos
they're = they are = son / están
I've = I have = he / tengo
you've = you have = has / tienes
we've = we have = hemos / tenemos
they've = they have = han / tienen
I'd = I would / I had = yo haría / yo había
you'd = you would / you had = tú harías / tú habías
he'd = he would / he had = él haría / él había
I'll = I will = yo voy a
you'll = you will = tú vas a
we'll = we will = nosotros vamos a
they'll = they will = ellos van a
can't = cannot = no poder
don't = do not = no (hacer)
doesn't = does not = no (hacer, 3ra persona)
didn't = did not = no (pasado)
won't = will not = no va a
wouldn't = would not = no haría
isn't = is not = no es / no está
aren't = are not = no son / no están
wasn't = was not = no era / no estaba
weren't = were not = no eran / no estaban
haven't = have not = no han / no tengo
hasn't = has not = no ha
hadn't = had not = no había
gimme = give me = dame
lemme = let me = déjame
wanna = want to = querer
gonna = going to = ir a
gotta = got to = tener que
yeah = sí (coloquial)
uh = eh (duda)
alright = bien / de acuerdo
kinda = kind of = como que
sorta = sort of = como que
me too = yo también
no way = ¡ni modo! / ¡de ninguna manera!
of course = por supuesto
by the way = por cierto
what about...? = ¿qué tal si...?
I guess = supongo
maybe = tal vez
probably = probablemente
actually = en realidad
definitely = definitivamente
really = realmente
just kidding = bromeando
never mind = no importa

=== 6. PHRASAL VERBS Y VERBOS POLISEMÁNTICOS (seleccionados) ===
get up = levantarse
get dressed = vestirse
get tired = cansarse
get home = llegar a casa
take a shower = ducharse
take a break = tomar un descanso
take care = cuidarse
put on = ponerse (ropa)
put off = posponer
put up with = aguantar
give up = rendirse
give in = ceder
give away = regalar / revelar
go on = continuar
go out = salir
go back = regresar
go away = irse
make up = inventar / reconciliarse
make sense = tener sentido
make a mistake = cometer un error
look for = buscar
look at = mirar
look after = cuidar
look forward to = esperar con ansias
turn on = encender
turn off = apagar
turn up = aparecer / subir volumen
turn down = rechazar / bajar volumen
pick up = recoger / aprender
pick out = elegir
run out of = quedarse sin
run into = encontrarse con
bring up = criar / mencionar
call off = cancelar
check in = registrarse
find out = descubrir
figure out = entender / resolver
grow up = crecer (edad)
hang out = salir (socializar)
hold on = esperar
keep on = seguir
let down = decepcionar
look up = buscar (información)
pass away = fallecer
show up = aparecer
take after = parecerse a (físicamente)
think over = pensarlo bien
try on = probarse (ropa)
work out = resolver / hacer ejercicio

=== 7. VOCABULARIO TÉCNICO / SOFTWARE ENGINEERING ===
software = software
code = código
program = programa
developer = desarrollador
engineer = ingeniero
debug = depurar
refactor = refactorizar
pipeline = tubería (CI/CD)
workflow = flujo de trabajo
deploy = desplegar
build = compilación / construcción
version = versión
repository = repositorio
commit = confirmar cambios
push = enviar cambios
pull = traer cambios
branch = rama
merge = fusionar
database = base de datos
server = servidor
client = cliente
API = API
endpoint = punto final
request = solicitud
response = respuesta
bug = error
feature = funcionalidad
framework = marco de trabajo
library = biblioteca
dependency = dependencia
documentation = documentación
test = prueba
unit test = prueba unitaria
integration = integración
agile = ágil
sprint = sprint
backlog = lista de pendientes
user story = historia de usuario
refactor = refactorizar
technical debt = deuda técnica
scalable = escalable
reliable = confiable
efficient = eficiente
robust = robusto

=== 8. CONECTORES Y ESTRUCTURAS LÓGICAS ===
because = porque
since = ya que
as = como / ya que
so = así que
therefore = por lo tanto
however = sin embargo
although = aunque
even though = aunque (énfasis)
though = aunque (al final)
but = pero
yet = pero (formal)
and = y
or = o
if = si
unless = a menos que
as long as = siempre que
provided that = con tal de que
when = cuando
while = mientras
before = antes de que
after = después de que
until = hasta que
by the time = para cuando
first = primero
next = siguiente
then = luego
finally = finalmente
for example = por ejemplo
such as = tales como
in other words = en otras palabras
on the other hand = por otro lado
in conclusion = en conclusión