
umbrella = paraguas
somebody = alguien
already = ya
something = algo
about = acerca de
cornerstones => piedra angular 
key = llave
begin = comience
beginner = principiante
places = lugares
carefull = con cuidado
got = tiene
gotta => tener que 
I've => Yo he/Yo tengo 
gimme => dame 
havent't = no tengo
statements = declaraciones
hair = pelo
air => aire 
blond = rubia
bounce => botar/rebotar 
about = sobre
taste => gusto/sabor 
boundary => limite/frontera 
issues = cuestiones
magazines = revistas
town => ciudad/pueblo grande 
toilet => water/inodoro 
garden = jardin
choose = elije
near = cerca de
ear => oreja/oido 
both = ambos
avoid => evitar 
lately => ultimamente/recientemente 
but = pero
travel = viaje
together = juntos
journey = viaje
have = tener/haber(cuando acompaña otro verbo)
whatch = ver
week = semana
whatever => lo que sea
sea => mar 
chore => tarea 
do you say => que opinas 
late = tardio
enough = suficiente
outside => exterior/de afuera
talk = hable
how = como
sense => sentido 
wear = desgaste
whant = quiero
learn = aprender
shoner = ducha
shop => tienda 
choose = elige
each = cada
honey = cariño/cielo 
sentence = frase/oración 
beginning => principio/comienzo 
thin = delgado
has = tiene
wife = esposa
son = hijo
talk = hablar
enjoy => disfrutar de
despite => a pesar de 
solid = sólido 
joy => alegría 
thorough => detallado/minucioso
big = grande
screen = pantalla
young = joven
lazy = peresozo 
crushing => demoledor/dora 
rush => precipitarse/darse prisa 
ships => barcos 
recluse => ermitaño/solitario 
split => dividir 
textbook => libro de texto 
fat = gordo
depth => profundidad 
proud => orgulloso
scrolling = desplazamiento
husband = marido
fair => justo
sun => sol  
pressure => presión 
resilient => fuerte/resistente 
useful => útil 
overwhelmed => abrumado/abrumada 
put = tiene varios significados, dependiendo el contexto en el que se utiliza, poner, escribir, expresar
make = hacer, realizar, produce
sometimes = a veces, en ocasiones
realizing => dándose cuenta
usually = generalmente
breakfast = desayuno, desayunar
breath => respiración/aliento 
unopened => sin abrir 
shortcoming => diferencia 
want = querer, desea
easier => más fácil 
wanna => quiero 
shaky => tembloroso 
for me = es para mi 
deal => trato/acuerdo 
nice => bonito
i believe = creo que
because = por que
eat = come 
unsure => inseguro/dudoso
but = pero * es una conjugacion en ingles para unir dos ideas contrarias o para indicar una excepcion
drink = beba
unshakable => inquebrantable 
express => expresar 
respect => admiración 
skill => habilidad/destreza 
advocate => recomendar/defender/abogar por 
shape => forma 
pull => arrastrar/tirar de 
brain => cerebro 
hush => silencio 
advice => consejo 
lemme => dejame 
early = inicio
less => menos 
answer = respuesta
nap => siesta 
swim => nadar 
silly => tonto/bobo 
to do => hacer 
ask => preguntar 
some = algunos
words = palabras
daughter = hija
aunt = tia 
both = ambos
sleep = dormir
regret => lamentación/arrepentimiento 
achieve => conseguir/lograr
I = yo
sitting => turno 
walk = camino
wall => muro/pared
fast = rápido
need = necesitar
skirt = falda
play = jugar
those = esos
but = pero
fireplace = chimenea
kitchen = cocina
cheap => barato 
cheaper -> más barato 
heap => monton 
chair = silla
basement = sótano
bedroom = dormitorio
beds = camas
Belive = creyendo
Jog = trotar
today = hoy
hired = contratado
busy = ocupado
upgrade => actualizar 
low = bajo
high = alta

----------------------
the => el/la/los/las
and => y
to => a 
of => de
a => un/una
in => en 
that => ese/esa
for => para/por
I => yo
you => tú/ustedes
he => él
she => ella
it => eso
we => nosotros/nosotras
they => ellos/ellas
them => ellas
I am => yo soy/estoy
this => esta
was => era/estaba
have => tener
or => o
at => en/a
not => no
your => tu
yourself => tu mismo/usted mismo 
cook => cocinar/preparar/hacerse 
cool => genial 
smoother => más suave 
smooth => liso/suave 
otherwise => si no 
from => de/desde
be => ser
by => por
will => será
can => poder/saber 
but => pero
as => como
are => están/son
on => en
all => todo
has => tiene
if => si
their => su(de ellos)
one => uno
do => hacer
doing => haciendo
my => mi
his => su(masculino)
there => ahí
about => acerca de/ sobre
which => cual
when => cuando
what? => qué
whisper => susurrar 
spread => extender/extenderse
major => importante/de envergadura
out => fuera
up => arriba
gave up => rendirse
schedule => horario 
our => nuestro
who => quien
also => además
had => tenía
some => alguno
any => ninguno
would => haría
wonderful => maravilloso
were => estuvieron/fueron/eran/estaban
like => gustar
lipe => labio 
been => estado/sido
just => solo/solamente/acabar de/justo/simplemente/apenas
her => ella
new => nuevo
other => otro
an => un
with => con
people => gente
buddy => amigo 
these => estas 
no => no
get => obtener
how? => cómo
me => yo
into => dentro
than => que/de
only => solamente
its => sus
most => más
moss => musgo 
may => podría
time => tiempo
many => muchos
salsa(de comida) => sauce 
cousin => primo/prima 
snap => romper/romperse/quebrar/quebrarse 
rising => en aumento 
make => hacer
terms => terminos 
then => entonces
well => bueno/bien
mortgage => hipoteca 
first => primero
pride => orgullo 
very => muy
over => terminado
couple => par/pareja 
now => ahora
could => podría
should => debería
even => incluso
because => porque
us => nosotros
said => dijo
saying => dicho/refran 
die => morir 
nobody => nadie 
good => bueno/bien
way => camino/manera
listening => escuchando 
hand => mano 
two => dos
more => más
work => trabajo
use => usar
after => después
through => a través de 
see => ver
seem => parecer 
know => saber/conocer
knocking => golpeando 
did => hizo/hacía
much => mucho
where => dónde
years => años
need => necesitar
him => él
back => espalda/atrás
pale => pálido 
saw => sierra 
such => tal/tanto
success => éxito
those => esos/aquellos
being => siendo
day => día
bakery => panadería 
take => tomar
while => mientras
here => aquí/acá
before => antes de
meaningful => significativo 
catch => atrapar/agarrar 
does => hace
great => genial
year => año
around => alrededor
of course => por supuesto
politeness => cortesía 
polite => educado/atento/correcto 
help => ayuda 
maybe => tal vez/quizás
I want => quiero
he/she wants => él/ella quiere
really? => realmente/verdaderamente/de verdad?/en serio?/
defiant => desafiante  
dad => padre 
think => opinar/pensar/creer
cry => llorar 
behind => detrás de/por detrás
smell => oler 
bench => banco
garbage => basura 
lifeline => salvamento 
best => mejor
wooden => de madera 
life => vida
each => cada
felt => sentido 
made => hecho
right => correcto
proof => prueba 
beyond => más allá de 
world => mundo
business => negocio
home => casa/hogar
own => propio/poseer
down => abajo
still => todavía
used => usado
find => encontrar
neglect => descuidar/desatender
go => ir 
going => yendo (voy)
every => cada
everything => todo/todas las cosas 
everyone => todo el mundo/todos 
both => ambos
last => último
apologize => disculparse 
off => apagado
falling => en caída 
too => también
same => mismo
mistake => equivocación/fallo 
fall => caer 
information => información
informed => bien informado/bien fundado 
little => pequeño/poco
another => otro
look => mirar
bet => apostar 
few => pocos
long => largo
ongoing => en curso 
part => parte
since => ya que/desde
things => cosas
place => sitio
sit => estar sentado/sentar/sentarse
idly => distraídamente 
eat => comer
between => entre
during => durante
different => diferente
must => deber
come => venir
come here => ven acá
using => utilizando
however => sin embargo
without => sin
high => alto
why? => por que?
something => alguna cosa
me too => yo también
instead => en vez de eso/en su lugar 
system => sistema
better => mejor
three => tres
never => nunca
always => siempre
newsletter => boletín informativo 
joke => chiste 
love => amor
among => entre 
warm => cálido/abrigado 
say => decir 
shame => una lástima/verguenza 
stiff => rigido/duro/tiezo 
awkward => dificil 
insurances => seguro 
bridge => puente 
might => podría
next => próximo
company => empresa
fit => quedar bien 
panic => pánico 
not yet => todavía no
freedom => libertad 
clue => pista 
number => número
again => de nuevo
gain => obtener 
got up => me levanté
against => en contra
free => gratis
a lot => mucho
under => debajo
family => familia
found => encontró
within => dentro
give => dar 
set => conjunto/fijar
settling => asentamiento
impress => imnpresionar 
impressive => imponente/impresionante 
unnatural => antinatural/anómalo 
degree => grado 
dissatisfaction => descontento 
facing => enfrentado 
jump => saltar 
odd => raro/extraño 
expected => esperado 
once => una vez
gate => puerta/porton 
stunning => impresionante  
school => colegio/escuela
important => importante
expect => esperar
lyrically => líricamente/poéticamente  
water => agua 
alongside => junto a/junto con 
workload => volumen de trabajo/carga de trabajo 
waterfall => cascada/catarata 
watch => mirar
able to =>  capaz de 
bluntly => sin rodeos
disagree => discrepar/estar en desacuerdo 
keep => mantener
got => tiene
sure => seguro/claro
clarity => claridad 
end => fin
money => dinero
later => más tarde 
inertia => inercia 
small => pequeño 
kidding => bromeando 
suppose => suponer 
although => aunque 
display => exponer 
put => poner
boat => barca/bote 
experience => experiencia
having => teniendo
once => una vez
available => disponible
onion => cebolla 
garlic => ajo 
health => salud
support => apoyo
often => a menudo
including => incluso/incluyendo
days => días
fade => desteñirse/desvanecerse 
away => lejos
awesome => increíble/asombroso 
bigger => mas grande 
old => viejo
area => zona
awful => horrible/espantoso 
feel => sentir
reminding => recordando
winter => invierno 
mindset => mentalidad 
remind => recordar 
record => registro 
killed => asesinado 
mind => mente
read => leer
showing => mostrando 
wind => viento 
angry => enfadado 
show => enseñar/mostrar 
shows => muestra/enseña 
big => grande 
against => en contra 
thing => cosa 
source => fuente 
strange => extraño 
order => orden 
probably => probablemente
though => aunque
run => correr 
thought => pensamiento  
city => ciudad 
soul => alma 
sound => sonido 
group => grupo 
services => servicios
site => sitio 
making => haciendo 
ground => suelo 
course => curso 
chilling => escalofriante/espeluznante 
point => punto 
children => niños 
times => veces 
team => equipo 
game => juego 
along => a lo largo 
let => dejar
approaching => aproxima 
approach => acercarse 
approached => se acerco 
alone => solo 
career => carrera 
carry => llevar 
house => casa 
partner => socio 
tight => apretado/riguroso  
today => hoy 
hover => cernerce/quedarse suspendido en el aire 
yesterday => ayer 
tomorrow => mañana 
working => trabajando 
research => investigación 
start => comienzo 
real => real
beat => ganar 
beaten => golpeado 
peace => paz 
body => cuerpo 
care => cuidado 
top => parte superior 
looking => mirando 
several => varios 
man => hombre 
calmness => calma 
lees => menos
broke => se rompió  
dot => punto/lunar 
folk => gente 
parish => parroquia 
process => proceso 
become => llegar a ser/convertirse en/volverse 
actually => realmente 
local => local 
together => juntos 
person => persona 
change => cambio 
book => libro 
enough => suficiente 
getting => consiguiendo 
week => semana 
booklet => folleto 
power => poder 
until => hasta 
market => mercado 
complain => quejarse 
fact => hecho/dato 
god => dios 
stuff => material/cosa 
food => comida 
study => estudiar 
students => estudiantes 
woman => mujer 
train => tren 
full => completo
second => segundo
data => dato
goverment => gobierno
quiet => callado 
says => dice 
others => otros 
ever => siempre 
prefer => preferir
fear => miedo  
feature => caracteristica 
yet => todavía 
case => caso 
development => desarrollo 
device => aparato 
gesture => gesto
red-eyed => inflarojos 
corporal => corporales 
left => izquierda 
far => lejos 
large => grande 
called => llamado 
already => ya 
came => vino/venía 
social => social 
open => abierto 
possible => posible 
side => lado 
play => jugar 
needs => necesidades 
try -> tratar 
done => hecho 
going => progreso
then => entonces
them => ellos/ellas, los/las
themselves => ellos mismos 
lost => perdido 
so => tan/muy/así que/tanto/así
act => comportarse
how => como
who => quién
delivery => reparto/entrega 
trying => duro
stage => etapa 
thing => cosa
some => algo de, algunos
unforeseen = imprevisto
actually => en realidad
well => bien
set => ambientar
phrase => frase/locución 
guidelines => pauta
when => cuando
inside => entrañas
huge => enorme 
give => dar 
dark = oscuro 
but => pero
delve => hurgar, escarbar
scared => asustado 
more => más
deep => profundo
funny => divertido 
dive => sumergirse/bucear 
driving => conducción
that => ese/esa
said => susodicho
whether => si
inventory => inventario
connect => conectar/conectarse/estar conectado 
say => decir
until => hasta
able => inteligente, capaz, hábil
tell => decir/contar 
which => que
quick => rápido
captivating => encantador/cautivador 
gonna => ir a
drive => conducir
allow => permitir
slurp => sorber/hacer ruido al beber 
treatment => tratamiento, trato
capability => capacidad, habilidad
which => que
reward => recompensa
choice => elección
know => saber
nowhere => ningún lugar/en ningún lugar 
fight => pelear/luchar
fighting => combate/lucha 
bread => pan
noise => ruido
slowly => lentamente  
doorstop => cuña
heaven => cielo
heavy => pesado 
think => opinar/pensar/creer
exchange => intercambio
slow => lento
maybe => quizá/tal vez
egg => huevo
cucumber => pepino
pepper => pimienta 
still => todavía
till => hasta 
making => fabricación
brighten => alegrar/alegrarse 
very => muy
know => saber
over => sobre
same => el mismo/similar
also => tambien
cover => t
apart => separados/aparte 
topic => temas
knowledge => conocimiento
edge => borde 
bubbly => lleno de vida/efervescente
give => dar
cargo => cargamento/carga 
take => llevarse
relationship => relación 
related => relacionado
whether => si
main => principal
payload => carga útil
some => algunos
there => allí/ahí
which => que
rely => depende de
manage => lograr
nagging => rezongón/gruñón 
below => debajo de 
consent => concentimiento
so => tan/entonces/así que/muy/así
must => deber
underpaid => mal pagado 
concern => preocupar 
trudge => caminar con dificultad 
building => construcción
build => contruir
any => algo/nada/algún
launch => lanzamiento
laugh => reírse
under => de bajo
scopes => examinar algo
mine => mío 
discover => descubrir
discovered => descubierto 
purpose => fin/finalidad
let => dejar/permitir
amount => cantidad 
mouth => boca 
provide => suministrar/proveer
wonder => preguntarse
keep => guardar/qudarse con
keeping => mantener 
track => via
Alrigth => muy bien/de acuerdo/esta bien
mate => compañero/colega/amigo/tío
just => ya, inmediatamente
yeah => si
cold => frío 
weak => débil 
privileged => privilegiado/honrado
agree => estar de acuerdo/ponerse de acuerdo
saying => dicho, refrán
holiday => vacaciones
highlight => destacar
light => luz/ligero 
survey => encuesta
weather => tiempo
often => a menudo
loan => préstamo 
bring => traer
may => poder
those => esos/estas
enough => suficiente
untrustable  => poco fiable
trust => confiar en/confiar 
powerful  => poderoso/potente/fuerte 
roommate => compañero
same => el mismo
tarnish => empañar/manchar
easy => fácil 
at least => al menos
caught => atrapado
cautionary => aleccionador/con moraleja  
grind => moler
grow => crecer
colorful => colorido 
growth => crecimiento 
movie => pelicula 
grown-up => adulto 
hang => colgar/espera 
hear => oír
setting => etorno/configuración 
heart => corazón 
heave => levantar/mover
hew => extraer/tallar/labrar
hide => esconder/esconderse
hit => golpear
climb => entrar/salir
hold => sostener/coger
hurt => herir/ofender
kneel => arrodillarse
knit => tejer, hacer punto
know => saber
lay => colocar
lean => inclinar/inclinarse
stay => quedarse
unpredictable => impredecible
rain => lluvia
struggle => pelear/forcejear
sad => triste
tried => intentar 
learning => aprendizaje 
improve => mejorar 
myself => me/para mi mismo/yo mismo/
grandpa => abuelo
look like => parecerce a/parecer que
rude => grocero/mal educado
wait => esperar
ensure => asegurar/garantizar
leap => saltar
learn => aprender
retrieve => recuperar 
delay => aplazar/retrasar 
certain => seguro 
leave => salir/irse
abroad => en el extranjero
broad => ancho/amplio 
road => calle
across => de un lado a otro
trouble => problemas 
ago => hace/atraz
quickly => rapidamente/deprisa 
ahead => delante, por delante
dangerous => peligroso
unlock => abrir
lock => cerradura
locked => bloqueado 
pristine => inmaculado/impecable 
ride => montar
cup => taza
sip => sorber/beber a sorbos/sorbo 
worry => preocuparse
lots => mucho
latte => café con leche
anything => cualquier cosa
else => si no
brownie => bizcocho de chocolate
croissant => media luna
stream => corriente
stretch => estirar/alargar 
listen => escuchar
fine => bien
theater => cine
pipeline => conducto 
heating => calentamiento 
hard => duro 
fun => diversión
trip => viaje/excursión/salida
spell => deletrear
reasons => razones
third => tercero
floor => suelo/piso
lift => levantar 
quite => completamente
means => medio/manera
meal => comida 
asleep => dormido 
cinderella => cenicienta 
indeed => efectivamente fg
strength => fuerza/fortaleza
tale => cuento/fábula
flower => flor  
lower => bajar 
measly => miserable 
complex => complejo
square => cuadrado
faced => de cara 
vision => imagen 
street => calle 
ghost => fantasma
leg => pierna 
piece => pedazo/trozo 
smile => sonrisa 
torch => linterna/antorcha 
song => canción 
relay => transmitir/retransmitir 
load => cargar 
vibe => ambiente/vibraciones 
enable => permitir 
camera => cámara 
cheering => animado 
incredible => increible 
bit => poco 
wild => desenfrenado/salvaje 
dinner => cena/comida 
tone => tono/timbre 
tonight => esta noche 
gonna => ir a 
luck => suerte 
amazing => asombroso/increíble
believe => creer 
daily => diario
punishment => castigo 
receipt => recibo 
pay => pagar 
painful => doloroso 
chance => oportunidad
departure => salida/partida 
alive => vivo 
awake => despierto 
awaken => despertar/despertarse 
wake => despertar/despertarse 
truly => de verdad/verdaderamente 
truth => verdad 
sort => clase/tipo 
sorted => arreglado/organizado 
thumb => pulgar 
lucky => afortunado 
keen => deseoso 
afraid => asustado 
fellow => compañeros de estudio/colegas
guess => adivinar
fell => sentir  
dream => sueño
dreadful => espantoso/terrible/atroz 
surprise => sorpresa 
rise => elevarse
bonus => bonificación 
tip => truco/consejo
aim => objetivo 
currently => actualmente
several => algunos 
attempting => intentando 
exposure => exposición 
entire => entero/todo 
explain => explicar 
guy => tipo/tío
slinky => juguete 
elven => elfos 
understand => entender/comprender 
neighbors => vecinos 
kind => amable/bondadoso 
nervous => nervioso 
bored => aburrido 
loss => pérdida 
forget => olvidar
blaming => culpar 
speech => discurso/habla 
anyway => de todos modos 
wonderful => maravilloso
lake => lago 
like => gustar/agradar 
fake => falso 
matter => materia
interesante => interesting 
rest => descansar 
hate => odio 
pleasant => agradable 
happened => sucedio/ocurrió
appear => aparecer  
shy => tímido
winner => ganador/ganadora 
shadow => sombra 
shadowing => siguiendo 
chaos => caos 
average => promedio 
promise => prometer 
sick => enfermo
lawyer => abogado/abogada
narrow => estrecho
none => ninguno/nadie/nada 
stake => participación 
stick => palo 
aloud => en voz alta
loud => fuerte/alto 
ready => listo/preparado 
kill => matar/destruir
bag => bolsa 
shoot => disparar a/fusilar 
sell => vender 
strong => fuerte 
stronger => mas fuerte 
friendly => simpático/amable 
west => oeste 
crazy => loco 
weird => muy raro 
corridor => pasillo 
separate => separado 
hell => infierno
scratch => arañar/rayar 
ruin => estropear/arruinar 
fried => frito 
anyone => alguien/nadie 
soon => pronto 
destroy => destruir 
discharge => liberar/dar de alta 
charge => cargo/carga 
herself => sola/ella misma 
missing => desaparecido 
singer => cantante 
toggle => alternar
whose => de quién 
glad => contento 
safe => seguro 
chapter => capitulo
wrong => equivocado 
wrote => escribió 
whole => todo/entero 
hiking => senderismo/excursionismo 
thinning => adelgazamiento 
hunker down => ponerse en cuclillas
chunks => trozos 
hope => esperar 
buy => comprar 
spend => gastar
pretty => bastante 
almost => casi 
as => tan/como 
converse => conversar 
kit => juego/equipo 
seen => visto 
kid => niño 
lockdow => confinamiento 
confident => seguro de sí mismo 
tough => resistente/fuerte 
trick => engaño/trampa 
accurate => preciso/exacto 
told => dijo 
practice => práctica 
pretend => fingir/simular/hacer como si 
guilty => culpable 
story => historia
touch => tocar
unavailable => ocupado 
forgot => olvide 
suggest => sugerir
sugar => azúcar 
pleased => contento 
exactly => exactamente
amphibian => anfibio 
trade => comercio
twice => dos veces  
ring => anillo/circulo 
submit => presentar/someter 
half => mitad 
went => fue 
took(pasado simple de take) => tomo
soft => blando

===================== palabras del libro Modern Software Engineering ======================
forward => hacia delante
mean => significar/querer decir
larger => mas grande
subject => asignatura, materia
understood => entendido/comprendido
even => hasta/ni siquiera
further => mas lejos
distinguish  => distinguir
like => como/por ejemplo
whether => si
knew => sabía
There were => había
There was => había
was => era/fue
through => a travez de/durante
someone => alguien
somewhere => a/en algún lugar 
thrid => tercero 
as long as => siempre y cuando